131111111111111111111111111111111111111111111111111
151655155522221555555555552222122212155515552222121
151115151512111511111111151112121212151515151112121
155515551512155512222215551222221222151555155512221
111511111512151111111215111112111111151111111511111
155515555512151222222215555512155555551222121515551
151115111111151212111211111512151111111212121515151
151225555555551212122222221512155512222212221555151
151111121111111112111111111511111512111112111111151
151555122222222212122212221515555512122222155555551
151515111111111212121212121515111112111111151111121
155515551555551212121222121515122222155515551222121
111111151511151212121111121515121211151515111212121
155555155515551212121222121555121222151555121212121
151115111115111212121212121111121112151111121212121
151215552215122212222212122222122212155512221212121
151211151115121111111111121112111212111512121212121
151215551555121222222222121212221212221512121212221
151215111511121212111112121211121212121512121211111
155515551512221212122212221222121212121512121222121
111511151512111112121211111211121212111512121112121
155515551512122212121222122212221212155512122212221
151115111512121212111212121212111112151112121111121
151215555512221222122212121212122212151222121222121
151211111111111111121111121212121212151212111212121
151555122225551222222222221212221212151212222212221
151515111115151112111111111211111212151112111112111
151515155515155512221222122222121222155512155512121
151515151515111511121212121112121112111511151512121
155515151515551555122212122212122212121555551512221
111115151512151115111111111212121112121111111511121
155555151512155515551555551212221222122222221512121
151111151511121511151511151211111211121112111512121
151225551555121555155512151222122212222212221512121
151115111115121115111112151112121111111211121512121
151555122215122215551222155512222222221222121512221
151511121215111111151212111511111111121211121512111
151512221215155515551212222555155512121212221512221
151511111215151515111111111115151512121212111511121
151555551215551515555555555515151512221212155512221
151211151211111512111111121515151511121112151112111
151215551222155512221555121515151555121222151222121
151115111112151111121515121515151115121212151112121
151555122222151222121515121515551225122212155512121
151511121212151112121515121512111115121111111512121
151512121212155512221515121512155515121555555512221
151512121211111511111515111511151515111511111111121
151512121212221515555515551555551515555512221222221
151512121212121515111111151111111511111112121211111
155512221222122555122222255555555512222222122222221
111111111111111111111111111111111411111111111111111
---
length=878
time=1830
