13111111111111111111111111111111111111111111111111111111111111111111111111111111111111111111111111111
15122225555515551222221225551555551222221225551222122555551222122555122212222222221222221222222222121
15111215111515151112121215151511151211121215151112121511151211121515121212111112121211111211111212121
15551215551555155512121215155515551222121215155512221515551222121515121212221212122212222212222212121
11151211151111111511121215111115111112111215111511111515111112121515121111121212111212111112111112121
12151222151555122512221215551215551222122215551555155515155512221515122212221212221212122222122212121
12151111151515111512121211151211151211121111151115151115151511111515111212111211121112121111121112121
12155555155515551512121215551215551222222215551215551555151515551515551222222222122222121212222212221
12111115121111151512111215111215111111111215111211111511151515151511151111111112111111121212111211121
15551555122212151512222215551555155555551215551222221512251515151555155555122212122212221222122212121
15151511111212151512111111151511151111151111151112121511151515151115111115121212111212111211121212121
15155512222222151512222212151512251555155555155512121555151555155515122215121212221212122212221212121
15111111111111151511111212151512151515111115121512111115151111111515121115121211121212111112111212121
15122555155555151512222222151512151515221555121512155555151222121515155555121222222212122212221212121
15111515151115151511111112151511151515111511111512151111151212121515151111121111111112121212121212121
15551515551555151555555512151515551515555512255512151555551212121515151555121222155512121212121212121
11151511111511151111111511151515111511111111151112151511111212121515151515121212151512121211121212121
15551512221555155555551555151555121512122555155512255512222212121515151515122212151512121212221212121
15111512111115121111151115151111121512121515111511111111121212121515151515111111151512121212111212121
15551512222215122222155515551222121512221515551555122222121212221515151515555555551512221212121212121
11151511111215111112111511111212121511111511151115121112121211121515151511111111111511121212121212121
12151515551555122212121555122212221555551555155515122212121222121555151512222212221555121212122222121
12151515151511111212121115111212111111151215111515121212111112121111151512111212121115111212111112121
12151555151555551222122215551212122222151215122555121212222222122222151515551222121555122212221222121
12151111151111151211121111151211121112151215121111121211111211111112151515151211111511121112121211121
12155515551555151212122222151212221222151215121555121212222215555512151515151215555512221212121212221
12111515111515151212121112151212111211151215111515121211121115111511151515151115111111121212121212111
12221555121515151212221222151212155515551215555515121222121555121515551515155555122222221222121212121
12111111121515151211111211151212151515111211111115111112121511121515111515111111111211111211121112121
15552212221515551212222215551212151515551215555515155512121555121555155515122222222212221222121222121
15151212121511111212111215111212151511151215111515151512111115121111151115111111121112121112121211121
15151212121555551212121215551222151512151215155515551512222555155555151215555555121222121222121222221
15151212121111151212121211151211151512151115151111111511111511151115151211111115121212121211121111121
15151222122215551222122222151215551512155555151555551555551512255515151222221215121212121222122222121
15151111121115111112111111151115111512111111151511151111151511111515151211121215121112111112111211121
15155512221555155512155515551555122555155515551512251555151515555515551212221215122212122212121222121
15111511111511151511151515111511111115151515111511151515151515111111111211121215111212121212121112121
15121555555515551555551555122515551225551515551555151515551515555512221222122215551212121222121222121
15121111111115111111111111121515151111111511151215151511111512111511121212111211151212121111121211121
15155512255515155512222555121555155555121512151215155515551512121555122212221215551212122212221222121
15151511151515151512111515121111111115121512151115111115151512121115111211121215111212111212121112121
15551515551515551512121515121555551555122555155555155555161512222215551222121215122212221212121212121
11111515111512111512121515111511151511111115111111151111111512111111151111121115121111121212121212121
12221515155512221512221515555512151555551215155512255555155512155555551222221555122222121212121212121
12111515151111121511111511111112151211151215151511121115151111151111111211121511121112121212121212121
12155515151212221555551555122555551212151215151555121555151555151555122212121555122212122222121212121
12151115151212111111151215111511111212151215151115111512151515151515111212121115111212111111121212121
15551555151222122212151215551512221212151555151215551512151515155515122212222215121212222212221212221
15111511151211121212151111151512121212151511151211151512151515111115121111111215121211111211121211111
15555512151222221212155515551512122212151555151555551512151515551555122222221215121212221222121222221
11111112151111111212111515111511121112151115151511111511151511151511121111121115121211121112121211121
12221222151555551212221515122555122222151555151555122515551512251555121222122215122222121222122212221
12121212151511151211121515111115111111151511151115111515111511151215121212111215111112121211111112111
12121212151512151212221515551225155555551555151225555515551555151215122212121215555512221222122222121
12111212151512151212111512151115151112111115151111111211151215151115111112121211111511121112111112121
12222212155512151212221512155515155512155515155512222222151215155555122212221222221512221212122212221
11111112111112151211121512111515111512151515111512111111151115111111121212111212111512111212121211111
12222212221222151222221512221515555512151515551512155515551555122212221212122212155512221212221222221
12111212121211151111121511111511111112151511151512151515111511121212121212121112151111121211111111121
12121212121215551222121555551512222222151555155512151555122555121222121212121212151222121222222212221
12121212121215111112121111151511111111151115111112151111121115121111121211121212151212121112121212111
12121212121215155512222215551555155515551215155512155512122215122222121212221212151212222212121212221
12121212121215151511111115111515151515111215151511111512121115111111121212111212151211111211121211121
12122212121215551555551555122515151555122215551555551512121555122222221222122212151215551222121212121
12121112121211111111151511111515151111121111111111151512121511121111111111121112151215151112121212121
12122222122212221555551515551515155512222555155555151512121512221555122212221222151215155512221222121
12111111111212111511111515151515111512111515151115151512121512121515111212121211151115111511111111121
12221222221222155512222555151515555512155515155515155512221512121515551212122215551555121555155555121
12121112121112151111111111151511111112151115111515111112111512111511151212111115111511121115151115121
12122212122212151225555555151515551222151555155515551212155512155512151222155555155512155555151555121
12111212111112151215111115151515151211151511151111151212151112151112151112151111151112151111151511121
12221212222222151215155555151515151222151515551215551222155512151222155512151555551555151225551515551
11121211111112151115151111151515151211151515111215111112111512151212111511151511111515151215111515151
12221222222212155555155515551555151215551555155515555512155515551215551515551515555515151215121555151
12111111111212111111111515111111151215111111151511111511151115111215151515111515111115151115121111151
12122212221212221222221515155515551215122222151555555515551215121215151555122515155555155515122222151
12121211121211121211121515151515111115121212151111111115111215121215151111121515151112111515121212151
12121212221222121222121515551515551555121212151555122555122215122215155555121515151222155515121212151
12121212111112121112121511111511151511111212151515111511121215111215111115111515151211151115121212151
12221212221222121222121555551512155512221212151515555512221215551215121555155515151212151225121212151
11111212121211121212111111151512111112121211151511111112111211151115121511151115151212151215111212151
12222212121222122212155522155512222222122215551512221222122222155555155512255515151222151215551212151
12111112121112111112151511111112111111121115111512121211121111111111151111111515151211151211151212151
12221212122212222212151555155555122222121555122512121212221555222215551555155515151215551222151212151
11121212111211111212151115151115121212121511111512121112111515111115111515151115151115111112151211151
12121222221212222212151215551215121212121555551512122222155515155515122515551215155555155512151215551
12121111111212111112151211111215121211121111151512111112151115151515121511111215111111151511151215111
12122222221212122222155512222215121222221215551512222212151215151555121555122215155512251555551215121
12111111121212111112111511111215121111111215111511111212151215151111121115121215151511151111111215121
12221222121212122212221555122215122212222215122515551212152215155512121215121215551555151555551225121
12121212121212121211111115121115111211121115111515151211151115111512121215111211111115151511151115121
12122212121212121215555555121555122222221555155515151222151555155512121215122215552215151512155515551
11111112121212121215111111121511111112111511151115151112151511151112121215121215151215151512111511151
12222222122212221215122222221555551222155512251555155512151555551222222215121215151215151512221555151
12111112111211111215111111121111151111151112151511111512151111111111111215121115151115151512121115151
12221212121212221215551555555512151555551222151515551512255515551555122215121555151555155522122215151
11121212121212121211151511111512151511111211151515151511111515151515111115121511151511121111111115151
12221222221212121222151512221555155515551222155515151555121515151515155515121512155512222215555515151
12111111111212121112151512121115111115151111111115151115121515151515151515121512111111111115111515151
12222222222222122212255512122225555555155555555555155555122555155515551555122555555555555555122555151
11111111111111111111111111111111111111111111111111111111111111111111111111111111111111111111111111141
---
length=2782
time=6376
